11.11.11.11.11.11.11.11.11.11.11.11.11.11.11.11.11.11.11.11.11.11.11.11.11.11.11.11.11.11.11.11.11.11.11.11.11.11.11.11
11.17.10.10.10.10.10.16.11.11.11.11.11.11.11.17.10.10.10.10.10.16.11.11.11.11.11.11.11.11.11.11.11.11.11.11.11.11.11.11
11.17.00.00.00.00.00.16.11.11.11.11.11.11.11.17.00.00.00.00.00.16.11.11.11.11.11.11.11.11.11.11.11.11.11.11.11.11.11.11
11.17.00.00.00.00.00.16.11.11.11.11.11.11.11.17.00.00.00.00.00.16.11.11.11.11.11.11.11.11.11.11.11.11.11.11.11.11.11.11
11.17.00.00.09.00.00.16.11.11.11.11.11.11.11.17.00.00.06.00.00.16.11.11.11.11.11.11.11.11.11.11.11.11.11.11.11.11.11.11
11.17.00.00.00.00.00.16.11.11.11.11.11.11.11.17.00.00.00.00.00.16.11.11.11.11.11.11.11.11.11.11.11.11.11.11.11.11.11.11
11.17.00.00.00.00.00.00.11.11.11.11.11.11.11.00.00.00.00.00.00.00.11.11.11.11.11.11.11.11.11.11.11.11.11.11.11.11.11.11
11.11.11.11.11.11.00.00.00.11.11.11.11.11.00.02.02.13.13.13.02.02.00.11.11.11.11.11.11.11.11.11.11.11.11.11.11.11.11.11
11.11.11.11.11.11.11.00.00.00.10.10.10.00.02.02.13.13.13.13.13.02.02.00.10.10.10.10.16.11.11.11.11.11.11.11.11.11.11.11
11.11.11.11.11.11.11.11.00.00.00.00.00.00.02.13.13.13.13.13.13.13.02.00.00.00.00.00.16.11.11.11.11.11.11.11.11.11.11.11
11.11.11.11.11.11.11.11.17.00.00.00.00.00.13.13.13.13.13.13.13.13.13.00.00.00.00.00.16.11.11.11.11.11.11.11.11.11.11.11
11.11.11.11.11.11.11.11.17.00.00.06.00.00.13.13.13.13.13.13.13.13.13.00.00.08.06.00.16.11.11.11.11.11.11.11.11.11.11.11
11.11.11.11.11.11.11.11.17.00.00.00.00.00.13.13.13.13.13.13.13.13.13.00.00.00.00.00.16.11.11.11.11.11.11.11.11.11.11.11
11.11.11.11.11.11.11.11.17.00.00.00.00.00.02.13.13.13.13.13.13.13.02.00.00.00.00.00.16.11.11.11.11.11.11.11.11.11.11.11
11.11.11.11.11.11.11.11.11.11.11.11.11.00.02.02.13.13.13.13.13.02.02.00.11.11.11.11.11.11.11.11.11.11.11.11.11.11.11.11
11.11.11.11.11.11.11.11.11.11.11.11.11.11.00.02.02.13.13.13.02.02.00.11.11.11.11.11.11.11.11.11.11.11.11.11.11.11.11.11
11.11.11.11.11.11.11.11.11.11.11.11.11.11.11.00.00.00.00.00.00.00.11.11.11.11.11.11.11.11.11.11.11.11.11.11.11.11.11.11
11.11.11.11.11.11.11.11.11.11.11.11.11.11.11.17.00.00.00.00.00.16.11.11.11.11.11.11.11.11.11.11.11.11.11.11.11.11.11.11
11.11.11.11.11.11.11.11.11.11.11.11.11.11.11.17.00.00.06.00.00.16.11.11.11.11.11.11.11.11.11.11.11.11.11.11.11.11.11.11
11.11.11.11.11.11.11.11.11.11.11.11.11.11.11.17.00.00.00.00.00.16.11.11.11.11.11.11.11.11.11.11.11.11.11.11.11.11.11.11
11.11.11.11.11.11.11.11.11.11.11.11.11.11.11.17.00.00.00.00.00.16.11.11.11.11.11.11.11.11.11.11.11.11.11.11.11.11.11.11
11.11.11.11.11.11.11.11.11.11.11.11.11.11.11.11.11.11.11.11.11.11.11.11.11.11.11.11.11.11.11.11.11.11.11.11.11.11.11.11
11.11.11.11.11.11.11.11.11.11.11.11.11.11.11.11.11.11.11.11.11.11.11.11.11.11.11.11.11.11.11.11.11.11.11.11.11.11.11.11