11.11.11.11.11.11.11.11.11.11.11.11.11.11.11.11.11.11.11.11.11.11.11.11.11.11.11.11.11.11.11.11.11.11.11.11.11.11.11.11
11.11.17.10.10.10.10.10.10.10.16.11.11.11.11.11.11.11.11.11.11.11.11.11.11.11.11.17.10.10.10.10.10.10.10.16.11.11.11.11
11.11.17.00.00.00.00.00.00.00.10.10.10.10.10.10.10.10.10.10.10.10.10.10.10.10.10.10.00.00.00.00.00.00.00.16.11.11.11.11
11.11.17.00.00.00.00.00.00.00.00.00.00.00.00.00.00.00.00.00.00.00.00.00.00.00.00.00.00.00.00.00.00.00.00.16.11.11.11.11
11.11.17.00.06.00.09.00.00.00.00.00.00.00.00.00.00.00.00.00.00.00.00.00.00.00.00.00.00.00.00.06.00.00.00.16.11.11.11.11
11.11.17.00.00.00.00.00.00.00.00.00.00.00.00.00.00.00.00.00.00.00.00.00.00.00.00.00.00.00.00.00.00.00.00.16.11.11.11.11
11.11.17.00.00.00.00.00.00.00.16.11.11.11.11.11.11.11.11.11.11.11.11.11.11.11.11.17.00.00.00.00.00.00.00.16.11.11.11.11
11.11.11.11.11.11.11.11.11.11.11.11.11.11.11.11.11.11.11.11.11.11.11.11.11.11.11.11.11.17.00.00.00.16.11.11.11.11.11.11
11.11.11.11.11.11.11.11.11.11.11.11.11.11.11.11.11.11.11.11.11.11.11.11.11.11.11.11.11.17.00.00.00.16.11.11.11.11.11.11
11.11.11.11.11.11.11.11.11.11.11.11.11.11.11.11.11.11.11.11.11.11.11.11.11.11.11.11.11.17.00.00.00.16.11.11.11.11.11.11
11.11.11.11.11.11.11.11.11.11.11.11.11.11.11.11.11.11.11.11.11.11.11.11.11.11.11.11.11.17.00.00.00.16.11.11.11.11.11.11
11.11.11.11.11.11.11.11.11.11.11.11.11.11.11.11.11.11.11.11.11.11.11.11.11.11.11.11.11.17.00.00.00.16.11.11.11.11.11.11
11.11.11.11.11.11.11.11.11.11.11.11.11.11.11.11.11.11.11.11.11.11.11.11.11.11.11.11.11.17.00.00.00.16.11.11.11.11.11.11
11.11.11.11.11.11.11.11.11.11.11.11.11.11.11.11.11.11.11.11.11.11.11.11.11.11.11.11.11.17.00.00.00.16.11.11.11.11.11.11
11.11.11.11.11.11.11.11.11.11.11.11.11.11.11.11.11.11.11.11.11.11.11.11.11.11.11.11.11.17.00.00.00.16.11.11.11.11.11.11
11.11.17.10.10.10.10.10.10.10.16.11.11.11.11.11.11.11.11.11.11.11.11.11.11.11.11.17.10.10.00.00.00.10.10.16.11.11.11.11
11.11.17.00.00.00.00.00.00.00.10.10.10.10.10.10.10.10.10.10.10.10.10.10.10.10.10.10.00.00.00.00.00.00.00.16.11.11.11.11
11.11.17.00.00.00.00.00.00.00.00.00.00.00.00.00.00.00.00.00.00.00.00.00.00.00.00.00.00.00.00.00.00.00.00.16.11.11.11.11
11.11.17.00.06.00.08.00.00.00.00.00.00.00.00.00.00.00.00.00.00.00.00.00.00.00.00.00.00.00.00.06.00.00.00.16.11.11.11.11
11.11.17.00.00.00.00.00.00.00.00.00.00.00.00.00.00.00.00.00.00.00.00.00.00.00.00.00.00.00.00.00.00.00.00.16.11.11.11.11
11.11.17.00.00.00.00.00.00.00.16.11.11.11.11.11.11.11.11.11.11.11.11.11.11.11.11.17.00.00.00.00.00.00.00.16.11.11.11.11
11.11.11.11.11.11.11.11.11.11.11.11.11.11.11.11.11.11.11.11.11.11.11.11.11.11.11.11.11.11.11.11.11.11.11.11.11.11.11.11
11.11.11.11.11.11.11.11.11.11.11.11.11.11.11.11.11.11.11.11.11.11.11.11.11.11.11.11.11.11.11.11.11.11.11.11.11.11.11.11