11.11.11.11.11.11.11.11.11.11.11.11.11.11.11.11.11.11.11.11.11.11.11.11.11.11.11.11.11.11.11.11.11.11.11.11.11.11.11.11
11.11.11.11.11.11.11.11.11.11.11.11.11.11.11.11.11.11.11.11.11.11.11.11.11.11.11.11.11.11.11.11.11.11.11.11.11.11.11.11
11.11.11.11.11.11.11.11.11.11.11.11.11.11.11.11.11.11.11.11.11.11.11.11.11.11.11.11.11.11.11.11.11.11.11.11.11.11.11.11
11.11.11.11.11.11.11.11.11.11.11.11.11.11.11.11.11.11.11.11.11.11.11.11.11.11.11.11.11.11.11.11.11.11.11.11.11.11.11.11
11.11.11.11.11.11.11.11.11.11.11.11.11.11.11.11.11.11.11.11.11.11.11.11.11.11.11.11.11.11.11.11.11.11.11.11.11.11.11.11
11.11.11.11.11.11.11.11.11.11.11.11.11.11.11.11.11.11.11.11.11.11.11.11.11.11.11.11.11.11.11.11.11.11.11.11.11.11.11.11
11.11.11.11.11.11.11.11.11.11.17.10.10.10.10.10.10.10.10.10.10.10.10.10.10.10.10.10.10.16.11.11.11.11.11.11.11.11.11.11
11.11.11.11.11.11.11.11.11.11.17.09.00.00.00.00.00.00.00.13.13.00.00.00.00.00.00.00.00.16.11.11.11.11.11.11.11.11.11.11
11.11.11.11.11.11.11.11.11.11.17.00.13.00.00.00.00.00.00.00.00.00.00.00.00.00.00.13.00.16.11.11.11.11.11.11.11.11.11.11
11.11.11.11.11.11.11.11.11.11.17.00.00.00.00.00.00.00.13.00.00.13.00.00.00.00.00.00.00.16.11.11.11.11.11.11.11.11.11.11
11.11.11.11.11.11.11.11.11.11.17.00.00.00.13.00.00.00.00.00.00.00.00.00.00.13.00.00.00.16.11.11.11.11.11.11.11.11.11.11
11.11.11.11.11.11.11.11.11.11.17.00.00.00.06.00.13.00.00.00.00.00.00.13.00.06.00.00.00.16.11.11.11.11.11.11.11.11.11.11
11.11.11.11.11.11.11.11.11.11.17.00.00.00.06.00.13.00.00.00.00.00.00.13.00.06.00.00.00.16.11.11.11.11.11.11.11.11.11.11
11.11.11.11.11.11.11.11.11.11.17.00.00.00.13.00.00.00.00.00.00.00.00.00.00.13.00.00.00.16.11.11.11.11.11.11.11.11.11.11
11.11.11.11.11.11.11.11.11.11.17.00.00.00.00.00.00.00.13.00.00.13.00.00.00.00.00.00.00.16.11.11.11.11.11.11.11.11.11.11
11.11.11.11.11.11.11.11.11.11.17.00.13.00.00.00.00.00.00.00.00.00.00.00.00.00.00.13.00.16.11.11.11.11.11.11.11.11.11.11
11.11.11.11.11.11.11.11.11.11.17.00.00.00.00.00.00.00.00.13.13.00.00.00.00.00.00.00.08.16.11.11.11.11.11.11.11.11.11.11
11.11.11.11.11.11.11.11.11.11.11.11.11.11.11.11.11.11.11.11.11.11.11.11.11.11.11.11.11.11.11.11.11.11.11.11.11.11.11.11
11.11.11.11.11.11.11.11.11.11.11.11.11.11.11.11.11.11.11.11.11.11.11.11.11.11.11.11.11.11.11.11.11.11.11.11.11.11.11.11
11.11.11.11.11.11.11.11.11.11.11.11.11.11.11.11.11.11.11.11.11.11.11.11.11.11.11.11.11.11.11.11.11.11.11.11.11.11.11.11
11.11.11.11.11.11.11.11.11.11.11.11.11.11.11.11.11.11.11.11.11.11.11.11.11.11.11.11.11.11.11.11.11.11.11.11.11.11.11.11
11.11.11.11.11.11.11.11.11.11.11.11.11.11.11.11.11.11.11.11.11.11.11.11.11.11.11.11.11.11.11.11.11.11.11.11.11.11.11.11
11.11.11.11.11.11.11.11.11.11.11.11.11.11.11.11.11.11.11.11.11.11.11.11.11.11.11.11.11.11.11.11.11.11.11.11.11.11.11.11