11.17.10.10.10.10.10.10.10.16.11.11.11.11.11.11.11.11.11.11.11.11.11.11.11.11.11.11.11.11.11.11.11.11.11.11.11.11.11.11
11.17.00.00.00.02.00.00.00.16.11.11.11.11.11.11.11.11.11.11.11.11.11.11.11.11.11.11.11.11.11.11.11.11.11.11.11.11.11.11
11.17.00.00.00.09.00.00.00.16.11.11.11.11.11.11.11.11.11.11.11.11.11.11.11.11.11.11.11.11.11.11.11.11.11.11.11.11.11.11
11.17.00.00.00.02.00.00.00.16.11.11.11.11.11.11.11.11.11.11.11.11.11.11.11.11.11.11.11.11.11.11.11.11.11.11.11.11.11.11
11.17.00.00.00.02.00.00.00.16.11.11.11.11.11.11.11.17.10.10.10.10.10.10.10.10.10.10.10.10.10.10.10.10.10.10.10.10.16.11
11.17.00.00.00.02.00.00.00.16.11.11.11.11.11.11.11.17.00.00.00.02.00.00.00.00.00.00.00.00.00.00.00.00.02.00.00.00.16.11
11.17.00.00.00.02.00.00.00.16.11.11.11.11.11.11.11.17.00.00.00.02.00.00.00.00.00.00.00.00.00.00.00.00.02.00.00.00.16.11
11.17.00.00.00.02.00.00.00.16.11.11.11.11.11.11.11.17.02.02.02.06.02.02.02.02.02.02.02.02.02.02.02.02.06.02.02.02.16.11
11.17.00.00.00.02.00.00.00.16.11.11.11.11.11.11.11.17.00.00.00.02.00.00.00.00.00.00.00.00.00.00.00.00.02.00.00.00.16.11
11.17.00.00.00.02.00.00.00.16.11.11.11.11.11.11.11.17.00.00.00.02.00.00.00.00.00.00.00.00.00.00.00.00.02.00.00.00.16.11
11.17.00.00.00.02.00.00.00.16.11.11.11.11.11.11.11.17.00.00.00.02.00.00.00.00.00.00.00.00.00.00.00.00.02.00.00.00.16.11
11.17.00.00.00.02.00.00.00.10.10.10.10.10.10.10.10.10.00.00.00.02.00.00.00.00.00.00.00.00.00.00.00.00.02.00.00.00.16.11
11.17.00.00.00.02.00.00.00.00.00.00.00.02.00.00.00.00.00.00.00.02.00.00.00.16.11.11.11.11.17.00.00.00.02.00.00.00.16.11
11.17.00.00.00.02.00.00.00.00.00.00.00.02.00.00.00.00.00.00.00.02.00.00.00.16.11.11.11.11.17.00.00.00.02.00.00.00.16.11
11.17.00.00.00.02.00.00.00.00.00.00.00.02.00.00.00.00.00.00.00.02.00.00.00.16.11.11.11.11.17.00.00.00.02.00.00.00.16.11
11.17.02.02.02.06.02.02.02.02.02.02.02.06.02.02.02.02.02.02.02.06.02.02.02.16.11.11.11.11.17.02.02.02.06.02.02.02.16.11
11.17.00.00.00.02.00.00.00.00.00.00.00.02.00.00.00.00.00.00.00.02.00.00.00.16.11.11.11.11.17.00.00.00.02.00.00.00.16.11
11.17.00.00.00.02.00.00.00.00.00.00.00.02.00.00.00.00.00.00.00.02.00.00.00.16.11.11.11.11.17.00.00.00.02.00.00.00.16.11
11.17.00.00.00.02.00.00.00.00.00.00.00.02.00.00.00.00.00.00.00.02.00.00.00.16.11.11.11.11.17.00.00.00.02.00.00.00.16.11
11.11.11.11.11.11.11.11.11.11.11.11.11.11.11.11.11.11.11.11.11.11.11.11.11.11.11.11.11.11.17.00.00.00.08.00.00.00.16.11
11.11.11.11.11.11.11.11.11.11.11.11.11.11.11.11.11.11.11.11.11.11.11.11.11.11.11.11.11.11.17.00.00.00.02.00.00.00.16.11
11.11.11.11.11.11.11.11.11.11.11.11.11.11.11.11.11.11.11.11.11.11.11.11.11.11.11.11.11.11.11.11.11.11.11.11.11.11.11.11
11.11.11.11.11.11.11.11.11.11.11.11.11.11.11.11.11.11.11.11.11.11.11.11.11.11.11.11.11.11.11.11.11.11.11.11.11.11.11.11