11.11.11.11.11.11.11.11.11.11.11.11.17.13.13.13.13.13.13.13.13.13.13.13.13.13.13.16.11.11.11.11.11.11.11.11.11.11.11.11
11.11.11.11.11.11.11.11.11.11.11.11.17.13.13.00.00.00.00.00.00.00.00.00.00.13.13.16.11.11.11.11.11.11.11.11.11.11.11.11
11.11.11.11.11.11.11.11.11.11.11.11.17.13.13.00.09.00.00.00.00.00.00.00.00.13.13.16.11.11.11.11.11.11.11.11.11.11.11.11
11.11.11.11.11.11.11.11.11.11.11.11.17.13.13.00.00.00.00.00.00.00.00.00.00.13.13.16.11.11.11.11.11.11.11.11.11.11.11.11
11.11.11.11.11.11.11.11.11.11.11.11.17.13.13.00.13.13.00.00.00.00.13.13.00.13.13.16.11.11.11.11.11.11.11.11.11.11.11.11
11.11.11.11.11.11.11.11.11.11.11.11.17.13.13.00.13.13.00.00.00.00.13.13.00.13.13.16.11.11.11.11.11.11.11.11.11.11.11.11
11.11.11.11.11.11.11.11.11.11.11.11.17.13.13.00.00.00.00.13.13.00.00.00.00.13.13.16.11.11.11.11.11.11.11.11.11.11.11.11
11.11.11.11.11.11.11.11.11.11.11.11.17.13.13.00.00.00.00.13.13.00.00.00.00.13.13.16.11.11.11.11.11.11.11.11.11.11.11.11
11.11.11.11.11.11.11.11.11.11.11.11.17.13.13.00.00.00.00.00.00.00.00.00.00.13.13.16.11.11.11.11.11.11.11.11.11.11.11.11
11.11.11.11.11.11.11.11.11.11.11.11.17.13.13.00.13.13.00.00.00.00.13.13.00.13.13.16.11.11.11.11.11.11.11.11.11.11.11.11
11.11.11.11.11.11.11.11.11.11.11.11.17.13.13.00.13.13.00.00.00.00.13.13.00.13.13.16.11.11.11.11.11.11.11.11.11.11.11.11
11.11.11.11.11.11.11.11.11.11.11.11.17.13.13.00.13.13.00.00.00.00.13.13.00.13.13.16.11.11.11.11.11.11.11.11.11.11.11.11
11.11.11.11.11.11.11.11.11.11.11.11.17.13.13.00.13.13.00.00.00.00.13.13.00.13.13.16.11.11.11.11.11.11.11.11.11.11.11.11
11.11.11.11.11.11.11.11.11.11.11.11.17.13.13.00.13.13.00.00.00.00.13.13.00.13.13.16.11.11.11.11.11.11.11.11.11.11.11.11
11.11.11.11.11.11.11.11.11.11.11.11.17.13.13.00.00.00.00.00.00.00.00.00.00.13.13.16.11.11.11.11.11.11.11.11.11.11.11.11
11.11.11.11.11.11.11.11.11.11.11.11.17.13.13.00.00.00.00.13.13.00.00.00.00.13.13.16.11.11.11.11.11.11.11.11.11.11.11.11
11.11.11.11.11.11.11.11.11.11.11.11.17.13.13.00.00.00.00.13.13.00.00.00.00.13.13.16.11.11.11.11.11.11.11.11.11.11.11.11
11.11.11.11.11.11.11.11.11.11.11.11.17.13.13.00.13.13.00.00.00.00.13.13.00.13.13.16.11.11.11.11.11.11.11.11.11.11.11.11
11.11.11.11.11.11.11.11.11.11.11.11.17.13.13.00.13.13.00.06.06.00.13.13.00.13.13.16.11.11.11.11.11.11.11.11.11.11.11.11
11.11.11.11.11.11.11.11.11.11.11.11.17.13.13.00.00.00.00.00.00.00.00.00.00.13.13.16.11.11.11.11.11.11.11.11.11.11.11.11
11.11.11.11.11.11.11.11.11.11.11.11.17.13.13.00.00.06.00.00.00.00.06.08.00.13.13.16.11.11.11.11.11.11.11.11.11.11.11.11
11.11.11.11.11.11.11.11.11.11.11.11.17.13.13.00.00.00.00.00.00.00.00.00.00.13.13.16.11.11.11.11.11.11.11.11.11.11.11.11
11.11.11.11.11.11.11.11.11.11.11.11.17.13.13.13.13.13.13.13.13.13.13.13.13.13.13.16.11.11.11.11.11.11.11.11.11.11.11.11