17.10.10.10.10.10.10.10.10.13.13.13.10.10.10.10.10.10.10.10.13.13.13.10.10.10.10.10.10.10.10.10.10.10.10.16.11.11.11.11
17.00.00.00.00.00.00.00.00.02.02.02.00.00.00.00.00.00.00.00.02.02.02.00.00.00.00.00.00.00.00.00.00.00.00.16.11.11.11.11
17.00.09.00.00.00.00.00.00.02.02.02.00.00.00.00.00.00.00.00.02.02.02.00.00.00.00.00.00.00.00.00.00.00.06.16.11.11.11.11
11.11.11.11.17.00.00.16.11.13.13.13.11.11.11.11.11.11.11.11.13.13.13.11.11.11.00.00.00.11.11.11.11.11.11.11.11.11.11.11
11.11.11.11.17.00.00.16.11.13.13.13.11.11.11.11.11.11.11.11.13.13.13.11.11.11.00.00.00.11.11.11.11.11.11.11.11.11.11.11
11.11.11.11.17.00.00.16.11.13.13.13.11.11.11.11.11.11.11.11.13.13.13.11.11.11.00.00.00.11.11.11.11.11.11.11.11.11.11.11
11.11.11.17.10.00.00.10.10.13.13.13.10.10.10.10.10.10.10.10.13.13.13.10.10.10.00.00.00.10.10.10.16.11.11.11.11.11.11.11
11.11.11.17.00.00.00.00.00.13.13.13.00.00.00.00.00.00.00.00.13.13.13.00.00.00.00.00.00.00.00.00.16.11.11.11.11.11.11.11
11.11.11.17.00.00.00.00.00.02.02.02.00.00.00.00.00.00.00.00.02.02.02.00.00.00.00.00.00.00.06.00.16.11.11.11.11.11.11.11
11.11.11.17.00.00.00.00.00.02.02.02.00.00.00.00.00.00.00.00.02.02.02.00.00.00.00.00.00.00.00.00.16.11.11.11.11.11.11.11
11.11.11.17.00.00.00.00.00.02.02.02.00.00.00.00.00.00.00.00.02.02.02.00.00.00.00.00.00.00.00.00.16.11.11.11.11.11.11.11
11.11.11.17.00.00.00.00.00.13.13.13.00.00.00.00.00.00.00.00.13.13.13.00.00.00.00.00.00.00.00.00.16.11.11.11.11.11.11.11
11.11.11.11.17.00.00.16.11.13.13.13.11.11.11.11.11.11.11.11.13.13.13.17.00.00.00.16.11.11.11.11.11.11.11.11.11.11.11.11
11.11.11.11.17.00.00.16.11.13.13.13.11.11.11.11.11.11.11.11.13.13.13.17.00.00.00.10.10.10.10.10.10.10.10.10.10.10.10.16
11.11.11.17.10.00.00.10.16.13.13.13.11.11.11.11.11.11.11.11.13.13.13.17.00.00.00.00.00.00.00.00.00.00.00.00.00.00.00.16
11.11.11.17.00.00.00.00.16.13.13.13.11.11.11.11.11.11.11.11.13.13.13.17.00.00.00.00.00.00.00.00.00.00.00.06.00.00.08.16
11.11.11.17.00.06.00.00.16.13.13.13.11.11.11.11.11.11.11.11.13.13.13.17.00.00.00.00.00.00.00.00.00.00.00.00.00.00.00.16
11.11.11.17.00.00.00.00.16.13.13.13.11.11.11.11.11.11.11.11.13.13.13.11.11.11.11.11.11.11.11.11.11.11.11.11.11.11.11.11
11.11.11.11.11.11.11.11.11.13.13.13.11.11.11.11.11.11.11.11.13.13.13.11.11.11.11.11.11.11.11.11.11.11.11.11.11.11.11.11
11.11.11.11.11.11.11.11.11.13.13.13.11.11.11.11.11.11.11.11.13.13.13.11.11.11.11.11.11.11.11.11.11.11.11.11.11.11.11.11
11.11.11.11.11.11.11.11.11.13.13.13.11.11.11.11.11.11.11.11.13.13.13.11.11.11.11.11.11.11.11.11.11.11.11.11.11.11.11.11
11.11.11.11.11.11.11.11.11.13.13.13.11.11.11.11.11.11.11.11.13.13.13.11.11.11.11.11.11.11.11.11.11.11.11.11.11.11.11.11
11.11.11.11.11.11.11.11.11.13.13.13.11.11.11.11.11.11.11.11.13.13.13.11.11.11.11.11.11.11.11.11.11.11.11.11.11.11.11.11