11.11.11.11.11.11.11.11.11.11.11.11.11.11.11.11.11.11.11.11.11.11.11.11.11.11.11.11.11.11.11.11.11.11.11.11.11.11.11.11
11.11.00.00.00.00.00.00.00.11.11.11.11.11.11.11.11.11.11.11.11.11.11.11.11.11.11.11.11.11.11.11.11.11.11.11.11.11.11.11
11.11.00.00.00.09.00.00.00.11.11.11.11.11.11.11.11.11.11.11.11.11.11.11.11.11.11.11.11.11.11.11.11.11.11.11.11.11.11.11
11.11.00.00.00.00.00.00.00.11.11.11.11.11.11.11.11.11.11.11.11.11.11.11.11.11.11.11.11.11.11.11.11.11.11.11.11.11.11.11
11.11.00.00.00.00.00.00.00.11.11.11.11.11.11.11.11.11.11.11.11.11.11.11.11.11.11.11.11.11.11.11.11.11.11.11.11.11.11.11
11.11.00.00.00.00.00.00.00.11.11.11.11.11.11.11.11.11.00.00.00.00.00.00.00.00.00.00.00.00.00.00.00.00.00.00.00.00.11.11
11.11.00.00.00.00.00.00.00.11.11.11.11.11.11.11.11.11.00.00.00.00.00.00.00.00.00.00.00.00.00.00.00.00.00.00.00.00.11.11
11.11.00.00.00.00.00.00.00.11.11.11.11.11.11.11.11.11.00.00.00.00.00.00.00.00.00.00.00.00.00.00.00.00.00.00.00.00.11.11
11.11.00.00.00.00.00.00.00.11.11.11.11.11.11.11.11.11.00.00.00.00.00.00.00.00.00.06.00.00.00.00.00.00.00.00.00.00.11.11
11.11.00.00.00.00.00.00.00.11.11.11.11.11.11.11.11.11.00.00.00.00.00.00.00.00.00.00.00.00.00.00.00.00.00.00.00.00.11.11
11.11.00.00.00.00.00.00.00.11.11.11.11.11.11.11.11.11.00.00.00.00.00.00.00.00.00.00.00.00.00.00.00.00.00.00.00.00.11.11
11.11.00.00.00.00.00.00.00.11.11.11.11.11.11.11.11.11.00.00.00.00.00.00.00.00.00.00.00.00.00.00.00.00.00.00.00.00.11.11
11.11.00.00.00.00.00.00.00.00.00.00.00.00.00.00.00.00.00.00.00.00.00.00.00.11.11.11.11.11.11.00.00.00.00.00.00.00.11.11
11.11.00.00.00.00.00.00.00.00.00.00.00.00.00.00.00.00.00.00.00.00.00.00.00.11.11.11.11.11.11.00.00.00.00.00.00.00.11.11
11.11.00.00.00.00.00.00.00.00.00.00.00.00.00.00.00.00.00.00.00.00.00.00.00.11.11.11.11.11.11.00.00.00.00.00.00.00.11.11
11.11.00.00.00.00.00.00.00.00.00.00.00.06.00.00.00.00.00.00.00.00.00.00.00.11.11.11.11.11.11.00.00.00.06.00.00.00.11.11
11.11.00.00.00.00.00.00.00.00.00.00.00.00.00.00.00.00.00.00.00.00.00.00.00.11.11.11.11.11.11.00.00.00.00.00.00.00.11.11
11.11.00.00.00.00.00.00.00.00.00.00.00.00.00.00.00.00.00.00.00.00.00.00.00.11.11.11.11.11.11.00.00.00.00.00.00.00.11.11
11.11.00.00.00.00.00.00.00.00.00.00.00.00.00.00.00.00.00.00.00.00.00.00.00.11.11.11.11.11.11.00.00.00.00.00.00.00.11.11
11.11.11.11.11.11.11.11.11.11.11.11.11.11.11.11.11.11.11.11.11.11.11.11.11.11.11.11.11.11.11.00.00.00.08.00.00.00.11.11
11.11.11.11.11.11.11.11.11.11.11.11.11.11.11.11.11.11.11.11.11.11.11.11.11.11.11.11.11.11.11.00.00.00.00.00.00.00.11.11
11.11.11.11.11.11.11.11.11.11.11.11.11.11.11.11.11.11.11.11.11.11.11.11.11.11.11.11.11.11.11.11.11.11.11.11.11.11.11.11
11.11.11.11.11.11.11.11.11.11.11.11.11.11.11.11.11.11.11.11.11.11.11.11.11.11.11.11.11.11.11.11.11.11.11.11.11.11.11.11