11.11.11.11.11.11.11.11.11.11.11.11.11.11.11.11.11.11.11.11.11.11.11.11.11.11.11.11.11.11.11.11.11.11.11.11.11.11.11.11
11.11.11.11.11.11.11.11.11.11.11.11.11.11.11.00.00.00.00.00.00.11.11.11.11.11.11.11.11.11.11.11.11.11.11.11.11.11.11.11
11.11.11.11.11.01.01.01.01.01.01.01.01.01.01.00.00.00.00.00.00.11.11.11.11.11.11.11.11.11.11.11.11.11.11.11.11.11.11.11
11.11.11.11.11.01.01.01.01.01.01.01.01.01.01.00.00.00.00.06.00.11.11.11.11.11.11.11.11.11.11.11.11.11.11.11.11.11.11.11
11.11.11.11.11.01.01.01.01.01.01.01.01.01.01.00.00.00.00.00.00.11.11.11.11.11.11.11.11.11.11.11.11.11.11.11.11.11.11.11
11.11.11.11.11.01.01.11.11.11.11.11.11.11.11.00.00.00.00.00.00.11.11.11.11.11.11.11.04.04.04.04.04.04.04.04.04.04.04.11
11.11.11.11.11.01.01.11.11.11.11.11.11.11.11.11.11.01.01.11.11.11.11.11.11.11.11.11.04.00.00.00.00.02.00.00.00.00.04.11
11.11.11.11.11.01.01.11.11.11.11.11.11.11.11.11.11.01.01.11.11.11.11.11.11.11.11.11.04.00.00.00.00.02.00.00.00.00.04.11
11.11.11.00.00.00.00.00.00.11.11.11.11.11.11.11.11.01.01.11.11.11.11.11.11.11.11.11.04.00.00.00.00.02.00.00.00.00.04.11
11.11.11.00.00.06.00.00.00.01.01.01.01.01.01.01.01.01.01.01.01.01.01.01.01.01.01.01.04.00.00.00.02.02.02.00.00.00.04.11
11.11.11.00.00.00.00.00.00.01.01.01.01.01.01.01.01.01.06.01.01.01.01.01.01.01.01.01.04.02.02.02.02.07.02.02.02.02.04.11
11.11.11.00.00.00.00.00.00.01.01.01.01.01.01.01.01.01.01.01.01.01.01.01.01.01.01.01.04.00.00.00.02.02.02.00.00.00.04.11
11.11.11.00.00.00.00.00.00.11.11.11.11.11.11.11.11.01.01.11.11.11.11.11.11.11.11.11.04.00.00.00.00.02.00.00.00.00.04.11
11.11.11.11.11.01.01.11.11.11.11.11.11.11.11.11.11.01.01.11.11.11.11.11.11.11.11.11.04.00.00.00.00.02.00.00.00.00.04.11
11.11.11.11.11.01.01.11.11.11.11.11.11.11.11.11.11.01.01.11.11.11.11.11.11.11.11.11.04.00.00.00.00.02.00.00.00.00.04.11
11.11.11.11.11.01.01.11.11.11.11.11.11.11.11.11.11.01.01.11.11.11.11.11.11.11.11.11.04.04.04.04.04.04.04.04.04.04.04.11
11.11.11.00.00.00.00.00.11.11.11.11.11.11.11.11.11.01.01.11.11.11.11.11.11.11.11.11.11.11.11.11.11.11.11.11.11.11.11.11
11.11.11.00.00.00.00.00.01.01.01.01.01.01.01.00.00.00.00.00.00.11.11.11.11.11.11.11.11.11.11.11.11.11.11.11.11.11.11.11
11.11.11.00.00.09.00.00.01.01.01.01.01.01.01.00.00.00.00.00.00.11.11.11.11.11.11.11.11.11.11.11.11.11.11.11.11.11.11.11
11.11.11.00.00.00.00.00.01.01.01.01.01.01.01.00.00.06.00.00.00.11.11.11.11.11.11.11.11.11.11.11.11.11.11.11.11.11.11.11
11.11.11.00.00.00.00.00.11.11.11.11.11.11.11.00.00.00.00.00.00.11.11.11.11.11.11.11.11.11.11.11.11.11.11.11.11.11.11.11
11.11.11.11.11.11.11.11.11.11.11.11.11.11.11.00.00.00.00.00.00.11.11.11.11.11.11.11.11.11.11.11.11.11.11.11.11.11.11.11
11.11.11.11.11.11.11.11.11.11.11.11.11.11.11.11.11.11.11.11.11.11.11.11.11.11.11.11.11.11.11.11.11.11.11.11.11.11.11.11